5555555578889555
5788895545551955
5455518835555655
5455555555555655
5122229578895655
5555554545565655
7888883545565195
4555555512235565
4555555555555565
1222222222955565
5555555555122235
5555555555555555